0 0 0 0 0 0 0 0 0 0 
0 0 X 0 0 0 0 0 0 0 
0 0 0 0 0 0 0 0 X 0 
X 0 0 0 0 X 0 l1 0 0 
0 0 0 0 0 0 0 0 0 0 
0 0 0 0 0 0 0 0 X 0 
X 0 0 0 0 0 0 0 0 0 
0 0 0 0 0 0 0 0 X 0 
X 0 0 0 0 0 0 0 0 0 
0 X 0 X 0 0 0 0 0 0 
