0 0 X X 0 0 l3 0 0 0 0 
0 0 l2 0 0 0 0 0 0 l1 0 
X 0 0 0 0 0 0 0 0 0 0 
0 0 X 0 0 0 0 0 0 0 0 
0 0 0 X l2 0 0 0 0 X 0 
0 0 0 0 0 0 0 0 0 0 0 
0 0 0 0 0 0 X 0 0 0 X 
l3 0 0 0 X 0 0 0 l1 0 0 
0 X 0 0 0 0 0 X 0 0 0 
0 0 0 0 0 0 0 0 0 X X 
X 0 0 0 0 0 0 0 0 0 X 
