0 l1 0 0 0 0 0 0 
0 l1 0 0 0 0 0 0 
0 0 l2 X 0 0 0 0 
0 0 0 0 0 0 0 0 
0 0 X 0 l1 0 0 0 
0 0 l2 0 0 l1 0 0 
0 0 0 0 0 l2 l1 0 
0 0 0 0 l1 0 0 0 
